TILEMAP
64 82                           	-- Size of tile map in tiles
16 16                   		-- Tile size & block size
images/tiles_chocolate_map.png          -- Tilesheet
16 8                                    -- Number of tiles in tilesheet
8 35 35 35 35 35 35 35 35 35 35 35 35 35 35 35 35 35 35 35 35 35 35 35 35 35 35 35 35 35 35 35 8 8 35 35 35 35 35 35 35 0 35 35 35 35 35 35 35 0 35 35 35 35 35 35 35 0 0 0 0 0 0 8 
8 0 0 0 0 35 35 0 0 0 0 0 0 0 35 35 0 0 0 0 35 35 0 0 0 0 0 0 0 0 35 35 8 8 35 35 35 35 35 35 35 0 35 35 35 35 35 35 35 0 35 35 35 35 35 35 35 0 0 0 0 0 0 8 
8 0 0 0 0 35 35 0 0 0 0 0 0 0 35 35 0 0 0 8 8 35 0 8 8 8 0 0 0 0 35 35 8 8 0 0 0 0 0 0 0 0 0 0 0 0 0 0 0 0 35 35 35 35 35 35 35 0 0 0 0 0 0 8 
8 0 3 4 0 35 35 0 0 0 0 0 0 0 35 35 0 0 8 8 35 35 0 0 0 0 0 0 0 0 35 35 35 0 0 0 0 0 0 0 0 0 0 0 0 0 0 0 0 0 35 35 35 35 35 35 35 0 0 0 0 0 0 8 
8 0 19 20 0 35 35 0 0 0 0 0 0 0 35 35 0 8 8 0 35 35 0 0 0 0 0 0 0 0 35 35 35 0 0 0 0 0 0 8 8 8 10 0 0 0 0 0 0 0 0 0 0 0 0 0 0 0 0 0 0 0 0 8 
8 0 19 20 0 35 35 0 0 0 0 0 0 0 35 35 0 0 0 0 35 35 0 0 0 0 0 0 0 0 35 35 35 0 0 0 0 0 0 8 8 8 8 10 0 0 0 0 0 0 0 0 12 27 12 0 0 0 27 12 0 0 0 8 
8 0 33 34 0 35 35 0 0 12 27 12 0 0 35 35 0 0 0 0 35 35 0 0 0 0 0 0 0 0 35 35 35 0 0 0 0 0 0 8 8 8 8 8 10 0 0 0 0 0 0 0 0 0 0 0 0 0 0 0 0 0 0 8 
8 0 49 50 0 35 35 0 1 2 0 1 2 0 35 35 0 1 2 0 35 35 0 0 0 40 0 0 0 0 35 35 35 0 0 0 0 0 8 8 8 8 8 8 8 10 0 0 0 5 6 0 21 22 0 37 38 0 40 0 0 0 0 8 
8 8 8 8 8 8 35 0 17 18 0 17 18 0 35 35 0 17 18 0 35 35 0 12 27 12 0 3 4 0 35 35 35 0 0 0 0 0 8 8 8 8 8 8 8 8 8 0 0 7 7 0 23 23 0 39 39 0 8 8 8 8 26 8 
8 8 8 8 8 8 0 0 33 34 0 33 34 0 0 0 0 33 34 0 0 0 0 0 0 0 0 33 34 0 0 0 0 12 27 0 0 0 8 8 8 8 8 8 8 8 8 0 0 7 7 0 23 23 0 39 39 0 8 8 8 8 26 8 
8 8 8 8 8 8 28 28 28 28 28 28 28 28 28 28 28 28 28 28 28 28 28 28 28 28 28 28 28 28 28 28 28 28 28 28 28 28 8 8 8 8 8 8 8 8 8 28 28 28 28 28 28 28 28 28 28 28 8 8 8 8 26 8 
8 8 8 8 8 8 8 8 8 8 8 8 8 8 8 8 8 8 8 8 8 8 8 8 8 8 8 8 8 8 8 8 8 8 8 8 8 8 8 8 8 8 8 8 8 8 8 8 8 8 8 8 8 8 8 8 8 8 8 8 8 8 26 8 
8 8 8 8 8 8 8 8 8 8 8 0 0 0 35 35 35 35 35 35 35 35 35 35 35 35 35 35 35 35 35 35 35 35 35 35 35 35 35 35 35 35 8 8 8 8 8 8 8 8 8 8 8 8 8 8 8 8 8 8 8 8 26 8 
8 8 8 8 8 8 8 8 8 8 8 0 0 0 35 35 35 0 0 0 0 35 35 0 0 0 0 0 0 35 35 35 35 0 0 0 0 0 35 35 35 0 8 8 8 8 8 8 8 8 8 8 8 8 8 8 8 8 8 8 8 8 26 8 
8 8 8 8 8 8 0 0 0 0 0 0 0 0 35 35 35 0 0 0 0 35 35 0 0 0 0 0 0 35 35 35 35 0 0 0 0 0 35 35 35 0 8 8 8 8 8 8 8 8 8 8 8 8 8 8 8 8 8 8 8 8 26 8 
8 8 8 8 8 0 0 0 0 0 0 0 0 0 35 35 35 0 0 0 0 35 35 0 0 0 0 0 0 35 35 35 35 0 0 0 0 0 35 35 35 0 8 8 8 8 8 8 8 8 8 8 8 8 8 8 8 8 8 8 8 8 26 8 
8 8 8 8 0 0 0 0 0 0 0 0 0 0 35 35 35 0 0 0 0 35 35 12 27 12 0 0 0 35 35 35 35 0 0 0 0 0 35 12 12 0 8 8 8 8 8 8 8 8 8 8 8 8 8 8 8 8 8 8 8 8 26 8 
8 8 8 0 0 0 0 9 8 8 8 0 0 0 35 35 35 0 0 0 0 35 35 0 0 0 0 0 0 35 35 35 35 0 0 40 0 0 35 35 8 0 8 8 8 8 8 8 8 8 8 8 8 8 8 8 8 8 8 8 8 8 26 8 
8 8 0 0 0 0 9 8 8 8 8 8 8 0 35 35 35 0 0 0 0 35 35 0 0 0 0 0 0 35 35 35 35 0 0 27 12 0 35 35 8 0 0 0 0 0 0 0 0 0 0 0 0 0 0 0 0 0 0 0 0 0 0 8 
8 0 0 0 0 9 8 8 8 8 8 8 8 0 35 35 35 12 27 12 0 35 35 0 0 40 0 0 0 0 0 0 0 0 0 0 0 0 35 35 8 40 0 41 0 41 41 0 0 41 0 41 41 0 0 40 0 41 0 0 0 0 0 8 
8 0 0 0 9 8 8 8 8 8 8 8 8 0 35 35 35 0 0 0 0 35 35 0 12 27 12 0 1 2 0 1 2 0 1 2 0 1 2 0 8 8 8 8 8 8 8 8 8 8 8 8 8 8 8 8 8 8 8 8 8 8 8 8 
8 0 0 9 8 8 8 8 8 8 8 8 8 0 35 35 35 0 0 0 0 35 35 0 0 0 0 0 17 18 0 17 18 0 17 18 0 17 18 0 8 8 8 8 8 8 8 8 8 8 8 8 8 8 8 8 8 8 8 8 8 8 8 8 
8 0 0 8 8 8 8 8 8 8 8 8 8 28 28 28 28 28 28 28 28 28 28 28 28 28 28 28 28 28 28 28 28 28 28 28 28 28 28 28 8 8 8 8 8 8 8 8 8 8 8 8 8 8 8 8 8 8 8 8 8 8 8 8 
8 0 0 8 8 8 8 8 8 8 8 8 8 8 8 8 8 8 8 8 8 8 8 8 8 8 8 8 8 8 8 8 8 8 8 8 8 8 8 8 8 8 8 8 8 8 8 8 8 8 8 8 8 8 8 8 8 8 8 8 8 8 8 8 
8 0 0 8 8 8 8 8 8 8 8 8 8 8 8 8 8 0 0 8 8 8 8 8 8 8 8 8 8 8 8 8 8 8 8 8 8 8 8 8 0 0 8 8 8 8 8 8 8 8 8 8 8 8 8 8 8 8 12 27 12 52 12 27 
8 0 0 0 0 0 0 0 0 0 0 0 0 0 0 0 0 0 0 0 0 0 0 0 0 0 0 0 0 0 0 8 8 8 8 8 8 8 8 8 0 0 8 8 8 8 8 8 8 8 8 8 8 8 8 8 8 8 27 70 67 68 69 70 
8 0 0 0 0 0 0 0 0 0 0 0 0 0 65 66 0 0 0 0 0 0 0 0 0 0 0 0 0 0 0 8 8 8 8 8 8 8 8 8 0 0 8 8 8 8 8 8 8 8 8 8 8 8 8 8 8 8 12 85 85 85 85 85 
8 0 0 0 0 0 0 0 0 0 0 65 66 0 81 82 0 0 0 0 0 0 0 0 0 0 0 0 0 0 0 8 8 8 8 8 8 8 8 8 0 0 0 0 0 0 0 0 0 0 0 0 0 0 0 0 0 8 27 86 86 86 86 86 
8 0 0 0 0 0 0 0 0 0 0 81 82 0 97 98 0 0 0 0 0 0 0 0 0 0 0 0 0 0 40 8 8 8 0 0 0 0 8 8 0 0 0 0 0 0 0 0 0 0 0 0 0 0 0 0 0 8 12 86 86 86 86 86 
8 0 0 0 0 0 0 0 0 0 0 97 98 0 97 98 0 0 0 0 0 24 25 24 25 24 25 24 25 24 25 8 8 0 0 0 0 0 8 8 8 8 0 8 8 8 8 8 8 8 8 8 8 26 0 0 0 8 27 12 27 12 27 12 
8 0 0 0 0 0 0 0 0 0 0 97 98 8 8 8 8 0 0 0 0 0 0 0 0 0 0 0 0 0 0 0 0 0 0 0 0 0 0 0 0 0 0 8 12 27 12 57 12 27 12 8 8 26 0 0 0 8 12 27 12 56 12 27 
8 0 0 0 0 0 0 0 41 0 0 8 8 8 8 8 8 0 0 0 0 0 0 0 0 0 0 0 0 0 0 0 0 0 0 0 0 0 0 0 0 41 41 8 27 74 74 73 74 74 27 8 8 26 0 0 0 8 27 71 71 72 71 71 
8 0 0 0 0 8 8 8 8 8 8 8 8 8 8 8 8 8 8 8 8 8 8 8 8 8 8 8 8 8 8 8 8 8 0 0 0 8 8 8 8 8 8 8 12 90 90 90 90 90 12 8 8 26 0 0 0 8 12 88 88 88 88 88 
8 0 0 0 0 8 8 8 8 8 8 8 8 8 8 8 8 8 8 8 8 8 8 8 8 8 8 8 8 8 8 8 8 8 0 0 0 8 8 8 8 8 8 8 27 89 89 89 89 89 27 8 8 26 0 0 0 8 27 87 87 87 87 87 
8 28 28 28 28 8 8 8 8 8 8 8 8 8 8 8 8 8 8 8 8 8 8 8 8 8 8 8 8 8 8 8 8 8 28 28 28 8 8 8 8 8 8 8 12 89 89 89 89 89 12 8 8 26 0 0 0 8 12 87 87 87 87 87 
8 8 8 8 8 8 8 8 8 8 8 8 8 8 8 8 8 8 8 8 8 8 8 8 8 8 8 8 8 8 8 8 8 8 8 8 8 8 8 8 8 8 8 8 27 12 27 12 27 12 27 8 8 26 0 0 0 8 27 12 27 12 27 12 
8 0 0 0 0 0 0 0 35 35 0 35 35 0 35 35 0 35 35 0 35 35 0 35 35 0 35 35 0 0 0 65 66 0 35 35 0 35 35 0 35 35 0 35 35 0 35 35 0 35 35 0 0 26 0 35 35 8 8 8 8 8 8 8 
8 0 65 66 65 66 0 0 35 35 0 35 35 0 35 35 0 35 35 0 35 35 0 35 35 0 35 35 0 0 0 81 82 0 35 35 0 35 35 0 35 35 0 35 35 0 35 35 0 35 35 0 0 26 0 35 35 0 0 0 35 35 8 8 
8 0 81 82 81 82 0 0 35 35 0 35 35 0 35 35 0 35 35 0 35 35 0 35 35 0 35 35 0 0 0 97 98 0 35 35 0 35 35 0 35 35 0 35 35 0 35 35 0 35 35 0 0 0 0 35 35 0 0 0 35 35 8 8 
8 0 97 98 97 98 0 0 35 35 0 0 0 0 35 35 0 0 0 0 35 35 0 0 0 0 35 35 0 0 0 97 98 0 35 35 0 35 35 0 35 35 0 35 35 0 35 35 0 35 35 0 0 0 0 35 35 0 0 0 35 35 8 8 
8 0 97 98 97 98 0 0 0 0 0 0 0 0 0 0 0 0 0 0 0 0 0 0 0 0 0 0 8 8 8 97 98 40 0 0 0 35 35 0 0 0 0 35 35 0 0 0 0 35 35 0 0 0 0 35 35 0 0 0 0 0 8 8 
8 26 8 8 8 8 0 0 0 0 0 0 0 0 0 0 0 0 0 12 0 0 0 0 0 0 0 0 8 8 8 8 8 8 0 0 0 0 0 0 0 0 0 0 0 0 0 0 0 0 0 0 0 0 0 0 0 0 0 0 0 0 8 8 
8 26 8 8 8 8 24 25 24 25 24 25 24 25 24 25 0 0 0 0 0 12 27 0 0 0 0 0 8 8 8 8 8 8 0 0 0 0 0 0 0 0 0 0 0 0 0 0 0 0 0 0 0 0 0 0 0 0 0 0 0 0 8 8 
8 26 8 8 8 8 8 8 8 8 8 8 8 8 8 8 0 0 0 0 0 0 0 0 0 0 0 0 8 8 8 8 8 8 0 0 0 0 0 0 0 0 0 0 0 0 0 0 0 0 0 0 0 0 0 0 0 0 0 0 0 0 8 8 
8 26 8 8 8 8 8 8 8 8 8 8 8 8 8 8 75 75 75 75 75 75 75 75 75 75 75 8 8 8 8 8 8 8 75 75 75 75 75 75 75 75 75 75 75 75 75 75 75 75 75 75 75 75 75 75 75 75 75 75 8 8 8 8 
8 26 8 8 8 8 8 8 8 8 8 8 8 8 8 8 91 91 91 91 91 91 91 91 91 91 91 8 8 8 8 8 8 8 91 91 91 91 91 91 91 91 91 91 91 91 91 91 91 91 91 91 91 91 91 91 91 91 91 91 8 8 8 8 
8 26 8 8 8 8 8 8 8 8 8 8 8 8 8 8 28 28 28 28 28 28 28 28 28 28 28 8 8 8 8 8 8 8 28 28 28 28 28 28 28 28 28 28 28 28 28 28 28 28 28 28 28 28 28 28 28 28 28 28 8 8 8 8 
8 26 8 8 8 8 8 8 8 8 8 8 8 8 8 8 28 28 28 28 28 28 28 28 28 28 28 8 8 8 8 8 8 8 28 28 28 28 28 28 28 28 28 28 28 28 28 28 28 28 28 28 28 28 28 28 28 28 28 28 8 8 8 8 
8 26 0 0 0 0 0 0 0 0 0 0 0 0 11 8 8 8 8 8 8 8 8 8 8 8 8 8 8 8 8 8 8 8 8 8 8 8 8 8 8 8 8 8 8 8 8 8 8 8 8 8 8 8 8 8 8 8 8 8 8 8 8 8 
8 26 0 0 0 0 0 0 0 1 2 0 0 0 0 11 8 8 8 8 8 8 8 8 8 8 8 8 8 3 4 54 0 3 4 0 54 0 3 4 0 0 0 0 8 8 8 8 8 8 8 8 8 8 8 8 8 8 8 8 8 8 8 8 
8 0 0 0 83 84 0 0 0 17 18 0 0 0 0 0 8 8 8 8 8 8 8 0 3 4 54 0 0 19 20 0 0 19 20 0 0 0 19 20 0 0 0 0 8 8 8 8 8 8 8 0 0 0 0 0 0 0 0 0 0 0 8 8 
8 0 0 99 100 102 103 0 0 33 34 0 0 0 0 0 3 4 0 54 3 4 0 0 19 20 0 0 0 19 20 0 0 19 20 0 0 0 19 20 0 0 0 0 8 8 8 8 8 8 8 0 0 0 0 0 0 0 0 0 0 0 8 8 
8 0 0 83 101 101 84 0 0 49 50 0 0 0 0 0 19 20 0 0 19 20 0 0 19 20 0 0 0 19 20 0 0 19 20 0 0 0 19 20 8 8 8 26 8 8 8 8 8 8 8 0 1 2 0 1 2 0 0 0 0 0 8 8 
8 0 99 100 101 101 102 103 8 8 8 8 10 0 0 0 19 20 0 0 19 20 0 0 19 20 0 0 0 19 20 0 0 19 20 0 0 0 19 20 8 8 8 26 8 8 8 8 8 8 8 0 17 18 0 17 18 0 0 0 40 40 8 8 
8 8 8 8 8 8 8 8 8 8 8 8 8 10 0 0 19 20 0 0 19 20 0 0 19 20 0 0 0 19 20 0 0 19 20 0 0 0 19 20 8 8 8 26 8 8 8 8 8 8 8 0 33 34 0 33 34 0 0 0 8 8 8 8 
8 27 12 27 12 27 8 27 12 27 12 27 8 8 10 0 19 20 0 0 19 20 0 0 19 20 0 0 0 8 8 8 8 8 8 8 8 8 8 8 8 8 8 26 8 8 8 8 8 8 8 40 40 50 0 49 50 0 0 0 8 8 8 8 
8 12 27 57 27 12 8 12 27 52 27 12 8 8 8 10 19 20 0 0 19 20 0 8 8 8 8 8 8 8 8 8 8 8 8 8 8 8 8 8 8 8 8 26 8 8 8 8 8 8 8 8 8 8 8 8 8 26 8 8 8 8 8 8 
8 27 74 73 74 27 8 27 67 68 69 27 8 8 8 8 8 8 8 8 8 8 8 8 8 8 8 8 8 8 8 8 8 8 8 8 8 8 8 8 8 8 8 26 8 8 8 8 8 8 8 8 8 8 8 8 8 26 8 8 8 8 8 8 
8 8 8 8 8 8 8 8 8 8 8 8 8 8 8 8 8 8 8 8 8 8 8 8 8 8 8 8 8 8 8 8 8 8 8 8 8 8 8 8 8 8 8 26 8 8 8 8 8 8 8 8 8 8 8 8 8 26 8 8 8 8 8 8 
8 8 8 8 8 8 8 8 8 8 8 8 8 8 8 8 8 8 8 8 8 8 8 8 8 8 8 8 8 8 8 8 8 8 8 8 8 8 8 8 8 8 8 26 8 8 8 8 8 8 8 8 8 8 8 8 8 26 8 8 8 8 8 8 
8 8 8 8 8 8 8 8 8 8 8 8 8 8 8 8 8 8 8 8 0 35 35 0 35 35 0 35 35 0 35 35 0 35 35 0 35 35 0 0 8 8 8 26 8 8 0 0 8 8 8 8 8 8 8 8 8 26 0 0 0 0 8 8 
8 0 0 0 0 0 0 0 0 0 65 66 0 0 0 0 8 8 8 26 0 35 35 0 35 35 0 35 35 0 35 35 0 35 35 0 35 35 0 0 8 8 8 26 8 8 0 0 8 8 8 8 8 8 8 8 8 26 0 0 0 0 8 8 
8 0 0 0 0 0 0 0 0 0 81 82 0 0 0 0 8 8 8 26 0 35 35 0 35 35 0 35 35 0 35 35 0 35 35 0 35 35 0 0 8 8 0 0 0 8 0 0 8 8 8 8 8 8 8 8 8 26 0 0 0 0 8 8 
8 0 0 0 0 0 0 0 0 0 97 98 0 0 0 0 0 8 8 26 0 0 0 0 35 35 0 0 0 0 35 35 0 0 0 0 35 35 0 0 8 8 0 0 0 0 0 0 0 0 0 0 0 0 0 0 0 26 0 0 0 0 8 8 
8 0 0 0 0 0 0 0 0 8 8 8 8 10 0 0 0 0 8 26 0 0 0 0 0 9 8 8 0 0 0 0 0 0 0 0 0 0 0 0 8 8 0 0 0 41 0 0 0 0 0 0 0 0 0 0 0 0 0 0 0 0 8 8 
8 40 0 0 0 0 0 0 40 8 8 8 8 8 10 0 0 0 0 0 0 0 0 0 9 8 8 8 24 25 24 25 0 0 0 0 0 0 0 0 8 8 8 8 8 8 8 8 8 8 8 8 8 8 8 8 0 0 0 0 0 0 8 8 
8 8 26 24 25 24 25 24 25 12 27 12 27 12 8 10 0 0 0 0 0 0 0 9 8 8 8 8 8 8 8 8 0 0 0 0 0 0 0 0 8 8 8 8 8 8 8 8 8 8 8 8 8 8 8 8 0 0 0 0 0 0 8 8 
8 8 26 8 8 8 8 8 12 27 12 56 12 27 12 8 10 0 0 0 0 0 9 8 8 8 8 8 8 8 8 8 0 0 0 8 8 8 0 0 0 0 0 0 0 0 0 0 0 0 0 0 0 0 0 0 0 0 0 0 0 0 8 8 
8 8 26 8 8 8 8 8 27 71 71 72 71 71 27 8 8 10 0 0 0 9 8 8 8 8 8 8 8 8 8 8 0 0 0 8 8 8 0 0 0 0 0 0 0 0 0 0 0 0 0 0 0 0 0 42 0 0 0 0 0 0 8 8 
8 8 26 8 8 8 8 8 12 88 88 88 88 88 12 8 8 8 8 8 8 8 8 8 8 8 8 8 8 8 8 8 0 0 0 8 8 8 8 8 8 8 8 8 8 8 8 8 8 8 8 8 8 8 8 8 8 8 0 0 0 0 8 8 
8 8 26 8 8 8 8 8 27 87 87 87 87 87 27 8 8 8 8 8 8 8 8 8 8 8 8 8 8 8 8 8 28 28 28 8 8 8 8 8 8 8 8 8 8 8 8 8 8 8 8 8 8 8 8 8 8 8 28 28 28 28 8 8 
8 8 26 8 8 8 8 8 12 87 87 87 87 87 12 8 8 8 8 8 8 8 8 8 8 8 8 8 8 8 8 8 8 8 8 8 8 8 8 8 8 8 8 8 8 8 8 8 8 8 8 8 8 8 8 8 8 8 8 8 8 8 8 8 
8 0 0 0 0 0 0 0 0 0 0 0 0 0 0 8 0 0 0 0 0 0 0 0 0 0 0 0 0 0 0 0 0 0 0 0 0 0 0 0 0 0 0 0 0 0 0 0 0 0 0 0 0 0 0 0 0 0 0 0 0 0 0 0 
8 0 0 0 0 0 0 0 0 0 0 0 0 0 0 8 0 0 0 0 0 0 0 0 0 0 0 0 0 0 0 0 0 0 0 0 0 0 0 0 0 0 0 0 0 0 0 0 0 0 0 0 0 0 0 0 0 0 0 0 0 0 0 0 
8 0 0 0 0 0 0 0 0 0 0 0 0 0 0 8 0 0 0 0 0 0 0 0 0 0 0 0 0 0 0 0 0 0 0 0 0 0 0 0 0 0 0 0 0 0 0 0 0 0 0 0 0 0 0 0 0 0 0 0 0 0 0 0 
8 0 0 0 0 0 0 0 0 0 0 0 0 0 0 8 0 0 0 0 0 0 0 0 0 0 0 0 0 0 0 0 0 0 0 0 0 0 0 0 0 0 0 0 0 0 0 0 0 0 0 0 0 0 0 0 0 0 0 0 0 0 0 0 
8 0 0 0 0 0 0 0 0 0 0 0 0 0 0 8 0 0 0 0 0 0 0 0 0 0 0 0 0 0 0 0 0 0 0 0 0 0 0 0 0 0 0 0 0 0 0 0 0 0 0 0 0 0 0 0 0 0 0 0 0 0 0 0 
8 0 0 0 0 0 0 0 0 0 0 0 0 0 0 8 0 0 0 0 0 0 0 0 0 0 0 0 0 0 0 0 0 0 0 0 0 0 0 0 0 0 0 0 0 0 0 0 0 0 0 0 0 0 0 0 0 0 0 0 0 0 0 0 
8 0 0 0 0 0 0 0 0 0 0 0 0 0 0 8 0 0 0 0 0 0 0 0 0 0 0 0 0 0 0 0 0 0 0 0 0 0 0 0 0 0 0 0 0 0 0 0 0 0 0 0 0 0 0 0 0 0 0 0 0 0 0 0 
8 0 0 0 0 0 0 0 0 0 0 0 0 0 0 8 0 0 0 0 0 0 0 0 0 0 0 0 0 0 0 0 0 0 0 0 0 0 0 0 0 0 0 0 0 0 0 0 0 0 0 0 0 0 0 0 0 0 0 0 0 0 0 0 
8 0 0 0 0 0 0 43 0 0 0 0 0 0 0 8 0 0 0 0 0 0 0 0 0 0 0 0 0 0 0 0 0 0 0 0 0 0 0 0 0 0 0 0 0 0 0 0 0 0 0 0 0 0 0 0 0 0 0 0 0 0 0 0 
8 8 8 8 8 8 8 8 8 8 8 8 8 8 8 8 0 0 0 0 0 0 0 0 0 0 0 0 0 0 0 0 0 0 0 0 0 0 0 0 0 0 0 0 0 0 0 0 0 0 0 0 0 0 0 0 0 0 0 0 0 0 0 0
