TILEMAP
66 12                           -- Size of tile map in tiles
16 16                   -- Tile size & block size
images/tiles_forest_practice_map.png                                     -- Tilesheet
8 4                          -- Number of tiles in tilesheet

MAP
17 0 0 0 0 0 0 0 0 0 0 0 0 0 0 0 0 0 0 0 0 0 0 0 0 0 0 0 0 0 0 0 0 0 0 0 0 0 0 0 0 0 0 0 0 0 0 0 0 0 0 0 0 0 0 0 0 0 0 0 0 0 0 0 0 17
17 0 0 0 0 0 0 0 0 0 0 0 0 0 0 0 0 0 0 0 0 0 0 0 0 0 0 0 0 0 0 0 0 0 0 0 0 0 0 0 0 0 0 0 0 0 0 0 0 0 0 0 0 0 0 0 0 0 0 0 0 0 0 0 0 17
17 0 0 0 0 0 0 0 0 0 0 0 0 0 0 0 0 0 0 0 0 0 0 0 0 0 0 0 0 0 0 0 0 0 0 0 0 0 0 0 0 0 0 0 0 0 0 0 0 0 0 0 0 0 0 0 0 0 0 0 0 0 0 0 0 17
17 0 0 0 0 0 0 0 0 0 0 0 0 0 0 0 0 0 0 0 0 0 0 0 0 0 0 0 0 0 0 0 0 0 0 0 0 0 0 0 0 0 0 0 0 0 0 0 0 0 0 0 0 0 0 0 0 0 0 0 0 0 0 0 0 17
17 0 0 0 0 0 0 0 0 0 0 0 0 0 0 0 0 0 0 0 0 0 0 0 0 0 0 0 0 0 0 0 0 0 0 0 0 0 0 0 0 0 0 0 0 0 0 0 0 0 0 0 0 0 0 0 0 0 0 0 0 0 0 0 0 17
17 0 0 0 0 0 0 0 0 0 0 0 0 0 0 0 0 0 0 0 0 0 0 0 0 0 0 0 0 0 0 0 0 0 0 0 0 0 0 0 0 0 0 0 0 0 0 0 0 0 9 9 9 9 9 9 9 9 9 9 9 9 9 9 9 17
17 0 0 0 0 0 0 0 0 0 0 0 0 0 0 0 0 0 0 0 0 0 0 0 0 0 0 0 0 0 0 0 0 0 0 0 9 9 9 9 0 0 0 0 0 0 0 0 0 9 17 18 17 18 17 18 17 18 17 18 17 18 17 18 17 17
17 0 0 0 0 0 0 0 0 0 0 0 0 0 9 9 9 9 9 9 9 9 9 0 0 0 0 0 0 0 0 0 0 0 0 9 17 18 17 18 9 0 0 0 0 0 0 0 9 17 18 17 18 17 18 17 18 17 18 17 18 17 18 17 18 17
17 9 9 9 9 9 9 9 9 9 9 9 9 9 17 18 17 18 17 18 17 18 17 0 0 0 0 9 9 9 9 9 9 9 9 17 18 17 18 17 18 9 0 0 0 0 0 9 17 18 17 18 17 18 17 18 17 18 17 18 17 18 17 18 17 17
17 17 18 17 18 17 18 17 18 17 18 17 18 17 18 17 18 17 18 17 18 17 18 0 0 0 0 17 18 17 18 17 18 17 18 17 18 17 18 17 18 17 9 9 9 9 9 17 18 17 18 17 18 17 18 17 18 17 18 17 18 17 18 17 18 17
0 0 0 0 0 0 0 0 0 0 0 0 0 0 0 0 0 0 0 0 0 0 0 0 0 0 0 0 0 0 0 0 0 0 0 0 0 0 0 0 0 0 0 0 0 0 0 0 0 0 0 0 0 0 0 0 0 0 0 0 0 0 0 0 0 0
0 0 0 0 0 0 0 0 0 0 0 0 0 0 0 0 0 0 0 0 0 0 0 0 0 0 0 0 0 0 0 0 0 0 0 0 0 0 0 0 0 0 0 0 0 0 0 0 0 0 0 0 0 0 0 0 0 0 0 0 0 0 0 0 0 0

DECORATIONS
17 19 20 19 20 7 8 19 20 27 28 27 28 25 26 25 15 16 25 26 0 25 26 25 26 27 28 27 28 19 20 15 16 19 20 27 28 19 20 27 28 27 28 25 26 25 26 0 0 25 26 0 25 15 16 26 25 26 25 26 0 0 25 26 0 17
17 27 28 27 28 15 16 27 28 25 26 25 26 0 0 0 7 8 0 0 0 0 0 0 0 25 26 25 26 27 28 7 8 27 28 25 26 27 28 25 26 25 26 0 0 0 0 0 0 0 0 0 0 7 8 0 0 0 0 0 0 0 0 0 0 17
17 25 26 25 26 7 8 25 26 0 0 0 0 0 0 0 15 16 0 0 0 0 0 0 0 0 0 0 0 25 26 15 16 25 26 0 0 25 26 0 0 0 0 0 0 0 0 0 0 0 0 0 0 15 16 0 0 0 0 0 0 0 0 0 0 17
17 0 0 0 0 15 16 0 0 0 0 0 0 0 0 0 7 8 0 0 0 0 0 0 0 0 0 0 0 0 0 7 8 0 0 0 0 0 0 0 0 0 0 0 0 0 0 0 0 0 0 0 0 23 24 0 0 0 0 3 0 0 0 0 0 17
17 0 0 0 0 7 8 0 0 0 0 0 0 0 0 0 15 16 0 0 0 0 0 0 0 0 0 0 0 0 0 15 16 0 0 0 0 0 0 0 0 0 0 0 0 0 0 0 0 0 0 0 6 31 32 14 0 0 3 11 12 0 0 0 0 17
17 0 0 0 0 15 16 0 0 0 0 0 0 0 0 0 23 24 0 0 0 0 0 0 0 0 0 0 0 0 0 7 8 0 0 0 0 0 1 2 0 0 0 0 0 0 0 0 0 0 9 9 9 9 9 9 9 9 9 9 9 9 9 9 9 17
17 0 3 0 0 23 24 0 0 3 0 3 0 0 0 6 31 32 14 0 0 0 0 0 0 0 0 0 0 0 0 15 16 0 0 0 9 9 9 9 0 0 0 0 0 0 0 0 0 9 17 18 17 18 17 18 17 18 17 18 17 18 17 18 17 17
17 3 11 12 6 31 32 14 3 11 12 11 12 0 9 9 9 9 9 9 9 9 9 0 0 0 0 0 0 0 0 23 24 0 0 9 17 18 17 18 9 0 0 0 3 0 0 0 9 17 18 17 18 17 18 17 18 17 18 17 18 17 18 17 18 17
17 9 9 9 9 9 9 9 9 9 9 9 9 9 17 18 17 18 17 18 17 18 17 0 0 0 0 9 9 9 9 9 9 9 9 17 18 17 18 17 18 9 0 3 11 12 0 9 17 18 17 18 17 18 17 18 17 18 17 18 17 18 17 18 17 17
17 17 18 17 18 17 18 17 18 17 18 17 18 17 18 17 18 17 18 17 18 17 18 0 0 0 0 17 18 17 18 17 18 17 18 17 18 17 18 17 18 17 9 9 9 9 9 17 18 17 18 17 18 17 18 17 18 17 18 17 18 17 18 17 18 17
4 4 4 4 4 4 4 4 4 4 4 4 4 4 4 4 4 4 4 4 4 4 4 4 4 4 4 4 4 4 4 4 4 4 4 4 4 4 4 4 4 4 4 4 4 4 4 4 4 4 4 4 4 4 4 4 4 4 4 4 4 4 4 4 4 4
4 4 4 4 4 4 4 4 4 4 4 4 4 4 4 4 4 4 4 4 4 4 4 4 4 4 4 4 4 4 4 4 4 4 4 4 4 4 4 4 4 4 4 4 4 4 4 4 4 4 4 4 4 4 4 4 4 4 4 4 4 4 4 4 4 4

ENEMIES
8 53 4
0 38 5
0 20 6
8 43 8

OBJECTS
1 63 4
0 22 6
0 35 6
4 34 7
